###################################
#S        #                       #
# ####### # ##################### #
# #     # # #         #         # #
# # ### # # # ####### # ####### # #
# # #   # # # #     # # #     # # #
# # # ### # # # ### # # # ### # # #
# # # #     # #   # #   #   # # # #
# # # ####### ##### ####### # # # #
# # #                       # # # #
# # ######################### # # #
# #                           # # #
# ############################# # #
#                               # #
# ############################### #
#                                E#
###################################