🧱🧱🧱🧱🧱🧱🧱🧱🧱🧱🧱🧱🧱🧱🧱🧱🧱🧱🧱🧱
🧱🏁　　　　　　　🧱　　　　　　　　　🧱
🧱　🧱🧱🧱🧱🧱🧱　🧱　🧱🧱🧱🧱🧱🧱🧱　🧱
🧱　🧱　　　　🧱　🧱　🧱　　　　　🧱　🧱
🧱　🧱　🧱🧱　🧱　🧱　🧱　🧱🧱🧱　🧱　🧱
🧱　　　　　　🧱　　　🧱　🧱🚪　　　　🧱
🧱🧱🧱🧱🧱🧱🧱🧱🧱🧱🧱🧱🧱🧱🧱🧱🧱🧱🧱🧱